# ACT.DFAssist english message

app-description=DFASSIST for ACT
app-name=DFASSIST
e-setting-load=Error on reading settings: {0}
e-setting-save=Error on saving settings
e-null-data=Null data found: {0}
i-data-version=Read game data (R:{2}/I:{1}/A:{0}/F:{3})
i-matched=Matched [{0}]
i-queue-instance=Start matching [{0}]
i-queue-roulette=Start roulette matching [{0}]
i-selected-color=Selected color is {0}
l-data-error=Error on processing data
l-fate-occured-info="{0}" spawned!
l-instance-enter=Enter: {0}
l-instance-leave=Leave: {0}
l-plugin-started=Plugin started
l-plugin-stopped=Plugin stopped
l-unknown-area=Unknown area ({0})
l-unknown-fate=Unknown FATE ({0})
l-unknown-instance=Unknown duty ({0})
l-unknown-roulette=Unknown roulette ({0})
ov-duties-wait=Duty waiting {0}
ui-alerts=Alerts
ui-back-color=Back Color
ui-clear-logs=Clear logs
ui-client-version=Version
ui-dbg=Debug: {0}
ui-display-font=Display font
ui-duty-finder=Duty finder
ui-enable-overlay=Enable overlay
ui-enable-sound=Enable sound
ui-instance=Instance
ui-fate=FATE
ui-find=Find
ui-in-game=In Game
ui-language=UI Language
ui-log-whole-fate=Logging whole FATEs
ui-reconnect=Reconnect
ui-select-sound=Select sound file
ui-tab-1-text=FATEs
ui-tab-2-text=Setting
ui-tab-3-text=Notify
tip-blink-overlay=Blink overlay window for easy find
tip-select-sound-dialog=Open dialog for select sound file
tip-sound-play=Play selected sound
ui-notify-use-line=Use LINE notify
ui-token=Token
ui-notift-test=Test Notify
ui-notify-use-telegram=Use Telegram notify
ui-id=ID
ui-show-log-setting=Logging area setting
i-client-version=Client version: {0}
i-visit-updated=Updated plugin found! Visit download website?
i-client-updated=Updated plugin found! New version is "{0}"

