# ACT.DFAssist 한국어 메시지

app-description=ACT에서 쓸 수 있는 DFASSIST 플러그인
app-name=DFASSIST
e-setting-load=설정 읽기 오류: {0}
e-setting-save=설정 저장 오류
e-null-data=빈값이 있습니다: {0}
i-data-version=데이터를 읽었습니다 (A:{0}/I:{1}/R:{2}/F:{3})
i-matched=Queue: 매치 잡힘 [{0}]
i-queue-instance=매치 시작 [{0}]
i-queue-roulette=루렛 시작 [{0}]
i-selected-color=선택한 색깔은 {0}입니다
l-data-error=데이터 처리에 문제가 있습니다
l-fate-occured-info="{0}" 떳다!
l-instance-enter=들어감: {0}
l-instance-leave=나옴: {0}
l-plugin-started=플러그인 시작
l-plugin-stopped=플러그인 중지
l-unknown-area=모르는 지역 ({0})
l-unknown-fate=모르는 FATE ({0})
l-unknown-instance=모르는 임무 ({0})
l-unknown-roulette=모르는 루렛 ({0})
ov-duties-wait=임무를 기다립니다 {0}
ui-alerts=경고
ui-back-color=배경색
ui-clear-logs=로그 지우기
ui-client-version=게임버전
ui-dbg=디버그: {0}
ui-display-font=로그 글꼴
ui-duty-finder=임무 파인더
ui-enable-overlay=오버레이 사용
ui-enable-sound=소리 사용
ui-instance=인스턴스
ui-fate=FATE
ui-find=찾기
ui-in-game=게임언어
ui-language=UI언어
ui-log-whole-fate=로그에 모든 페이트 표시
ui-reconnect=재접속
ui-select-sound=소리 파일을 선택해주세요
ui-tab-1-text=돌발
ui-tab-2-text=설정
ui-tab-3-text=알림
tip-blink-overlay=오버레이 창을 쉽게 찾기 위해 깜빡입니다
tip-select-sound-dialog=소리 파일을 고르기 위한 대화창을 엽니다
tip-sound-play=선택한 소리를 재생합니다
ui-notify-use-line=라인 알림을 사용합니다
ui-token=토큰
ui-notift-test=알림 테스트
ui-notify-use-telegram=텔레그람 알림을 사용합니다
ui-id=아이디
ui-show-log-setting=로그 윈도우 설정
i-client-version=클라이언트 버전: {0}
i-visit-updated=새로운 플러그인이 있습니다. 다운로드 웹사이트로 이동할까요?
i-client-updated=새로운 플러그인이 있습니다. 버전은 "{0}"입니다
