# ACT.DFAssist にほんご メッセージ

app-description=ACT用のDFASSISTプラグイン
app-name=DFASSIST
e-setting-load=設定読みにエラー: {0}
e-setting-save=設定保存にエラー
e-null-data=空きデータが見つかりました: {0}
i-data-version=データを読みました (A:{0}/I:{1}/R:{2}/F:{3}) #{4}
i-matched=準備完了 [{0}]
i-queue-instance=コンテンツ参加申請開始 [{0}]
i-queue-roulette=ルーレット参加申請開始 [{0}]
i-selected-color=選択した色は{0}です
l-data-error= データ処理に問題があります
l-fate-occured-info="{0}" 発生!
l-instance-enter=入場: {0}
l-instance-leave=退場: {0}
l-plugin-started=プラグイン開始
l-plugin-stopped=プラグイン停止
l-unknown-area=知らないエリア ({0})
l-unknown-fate=知らないFATE ({0})
l-unknown-instance=知らないコンテンツ ({0})
l-unknown-roulette=知らないルーレット ({0})
ov-duties-wait=コンテンツを待っています {0}
ui-alerts=アラート
ui-back-color=背景色
ui-clear-logs=ログクリア
ui-client-version=ｹﾞｰﾑﾊﾞｰｼﾞｮﾝ
ui-dbg=テストメッセージ: {0}
ui-display-font=ログフォント
ui-duty-finder=コンテンツファインダー
ui-enable-overlay=オーバーレイ使用
ui-enable-sound=サウンド使用
ui-instance=ID
ui-fate=FATE
ui-find=検索
ui-in-game=ゲーム言語
ui-language=UI言語
ui-log-whole-fate=全てのFATEを通報
ui-reconnect=再コネクト
ui-select-sound=サウンドファイルを選んでください
ui-tab-1-text=ﾌｪｲﾄ
ui-tab-2-text=設定
ui-tab-3-text=通知
tip-blink-overlay=オーバーレイウィンドウを簡単に探すのにうっかりうっかりします
tip-select-sound-dialog=サウンドファイルを選ぶためのダイアログを開きます
tip-sound-play=選んだサウンドを再生します
ui-notify-use-line=ライン通知を使用します
ui-token=トークン
ui-notift-test=通知テスト
ui-notify-use-telegram=Telegram 通知を使用します
ui-id=ID
ui-show-log-setting=ログウィンドウ設定
ui-preset=プリセット
i-client-version=クライエント・バーション: {0}
i-visit-updated=新しいプラグインがあります。 ダウンロードサイトに移動しますか？
i-client-updated=新しいプラグインがあります。 バージョンは"{0}"です
